1111111
1P00001
1111101
1000001
1011111
1C000C1
111C111
1000001
1111101
1E00001
1111111