111111111
1P00000C1
111111101
1E0000001
111111111