1111111111
1000C00001
1P00001001
10000010E1
1111111111