1111111111
1CCCCCCCC1
1PCCCSCCC1
1CCCCCCCE1
1111111111