11111111
1P000001
111111C1
1E000001
11111111