1111111111111
1P000C0000CC1
11111111111C1
1E000C0000CC1
1111111111111