11111111
1P000001
11111101
10000001
1C111111
100000C1
111C1111
1C0000C1
11111101
1E100101
10111101
10000001
11111111