11111111111111111111
1P1C1C1C1C1C1C1C1111
100000000000000000E1
11C1C1C1C1C1C1C1C111
11111111111111111111