111111111111111111111111111111111111111
1P000C00000011000011111111C01C0010000C1
11111111111000011C1110000000111010111C1
1E0000000000111110000011110000000000111
111111111111111111111111111111111111111