11111111111111111111
1P000000010001010001
11111111010101000101
100000000101010101C1
1C11111111010C010111
10000000000101010001
11111111111111110101
1E0000000000000001C1
11111111111111111111