1111111111111
100C00000C001
1P0000E000001
100C00000C001
1111111111111