1111111111111
100C000000001
1P0000E000001
1000000000001
1111111111111