11111
1PCE1
10001
10001
11001
11111