1111111
110C011
1P0S0C1
1E0C011
1111111