1111111111111111111111111111111
1001000100010001000100010001001
1010001000100010001000100010001
1000100010001000100010001000101
1010001000100010001000100010001
1000100010001000100010001000101
1PCE100010001000100010001000101
1111111111111111111111111111111