11111111
1P000001
11111S01
10000001
1CS11111
100000C1
11SCS111
1C0000C1
11111101
1E1SS101
10111101
10000001
11111111