111111111111111111111111111111111111111
1P000C0000CC111111111110000000000000001
11111111111C0000000000000000000000000C1
1E0000000000111111111110000000000000001
100000000000000000000000000000000000001
111111111111111111111111111111111111111