11111111111111111111111
1P0000C0000000000000001
11111111111111111111101
1E000000000000000000001
11111111111111111111111