11111111
1P000001
1111SCS1
1E0000C1
11111111