111111111111111111111111111111111111111
1P000C00000011000011111111C01C0010000C1
1111111111S0000S1C11100000001110S0111C1
1E0000000000111110000011110000000000111
111111111111111111111111111111111111111