111111
1P00C1
1111C1
1E00C1
1111C1
1S00C1
1111C1
1E0001
111111